1111111111
1P0000E001
100C000001
1111111111